; en
[generic]
ok=OK
cancel=Cancel
close=Close
enabled=Enabled
inventory=Inventory
stats=Statistics
error=Error
food=Food
skills=Skills
subject=Subject
bug_report=Bug report
equip=Equipment
text=Text
update_version=Update Version
add=Add
send=Send
required=Required
total=Total
hotbars=Hotbars
required_items=Items Required
result_items=Result Item
quit=Quit
options=Options
loading=Loading...
create=Create
delete=Delete
nickname=Nickname
[login]
select_char=Select character
login=Login
logout=Logout
save_pass=Remember password
create_char=Create character
account=Account
password=Password
[sysmsg]
welcome=Welcome to Origin world!
[net_error]
login=Log in...
disconnected=Dicsonnected
refused=Connection refused
connect_error=Network error
wrong_password=Wrong password
user_not_found=User not found
banned=Banned
account_in_use=Account in use
timeout=Timeout
unknown_reason=Unknown reason
packet=Packet error
